9 16
################
#####  ######  #
#  *  O##  *  O#
# ###  ## ###  #
#  O       O   #
# ###  ## ###  #
# -*   ##  *   #
#####  ######  #
################
