9 8
########
#####  #
#      #
# ### -#
#  O   #
# ###  #
#  *   #
#####  #
########
