7 8
########
#     ##
#     ##
#  #-###
#   O* #
##  #  #
########


7 8
########
#     ##
#     ##
#  #-###
#   O* #
#   #  #
########
