6 6
######
#   -#
#    #
# #* $
#O#  #
######
