9 16
################
#####  ######  #
#      ##  *   #
# ###  ## ###  #
#  O           #
# ###  ## ###  #
# -    ##      #
#####  ######  #
################
