9 8
########
#####  #
#      #
# ###  #
#      #
# ###  #
#      #
#####  #
########
2 1
6 4
